*************************
*___________oo__________*
*__________o__o_________*
*_________o____o________*
*________o__0___o_______*
*______oo________oo_____*
*_____o____________o____*
*_______________________*
*__$___^^^^^^^^^^^^_____*
*______^^^^^^^^^^^^_____*
*___H_______________H___*
*______M____M____M______*
*~~~~~~~~~~~~~~~~~~~~~~~*
*************************
