*************************
*^^^^^^^^^^^^^^_________*
*^^^^^^^^^^^^^^_________*
*^^^^^^^^^^^^^^_________*
*^^^^^^^^^^^^^^_________*
*[[[[[[[[[[[[[[_________*
*~~~~~~~~~~~~~~_________*
*~~~~~~~~~~~~~~_________*
*_______________________*
*_______________________*
*_____$_________________*
*_______________________*
*____H________M______H_M*
*************************
